# GTAmini地图文件
# 格式说明：
# R - 道路
# I - 十字路口
# B - 建筑物
# S - 人行道
# W - 水域
# 地图大小：20x20

WWWWWWWWWWWWWWWWWWWW
WWWWWWWWWWWWWWWWWWWW
WWSSSSSSSSSSSSSSSSWW
WWSBBBBSBBBBSBBBBSWW
WWSBBBBSBBBBSBBBBSWW
WWSSSSSISSSISSSSSWW
WWSBBBBRRRRRRRBBBSWW
WWSBBBBRBBBBBRBBBSWW
WWSBBBBRBBBBBRBBBSWW
WWSSSSSISSSSIRRRIWW
WWSBBBBRBBBBBRBBBSWW
WWSBBBBRBBBBBRBBBSWW
WWSBBBBRRRRRRRBBBSWW
WWSSSSSISSSISSSSSWW
WWSBBBBSBBBBSBBBBSWW
WWSBBBBSBBBBSBBBBSWW
WWSBBBBSBBBBSBBBBSWW
WWSSSSSSSSSSSSSSSSWW
WWWWWWWWWWWWWWWWWWWW
WWWWWWWWWWWWWWWWWWWW